NO ./textures/WallN.xpm
SO ./textures/WallS.xpm
WE ./textures/WallW.xpm
EA ./textures/WallE.xpm
F 72,72,72
C 32,32,32

111111111111111111
111111111000000001
     1000001000001
     1000001010001
     1000N00000001
     1111111111111
