NO ./textures/WallN.xpm
SO ./textures/WallS.xpm
WE ./textures/WallW.xpm
EA ./textures/WallE.xpm

F 50,50,50
C 135,206,235

1111111111111111111111111111111111111111111111111111111111111111111111
1000000000000000000000000000000000000000000000000000000000000000000001
1011111111111111111111111111111111110000000000000000000000000000000001
1010000000000000000000000000000000010000000000000000000000000000000001
1010111111111111111111111111111110010000000000000000000000000000000001
1010100000000000000000000000000010010000000000000000000000000000000001
1010101111111111111111111111111010010000000000000000000000000000000001
1010101000000000000000000000001010010000000000000000000000000000000001
1010101011111111111111111111101010010000000000000000000000000000000001
1010101010000000000000000000101010010000000000000000000000000000000001
1010101010111111111111111110101010010000000000000000000000000000000001
1010101010100000000000000010101010010000000000000000000000000000000001
1010101010101111111111111010101010010000000000000000000000000000000001
1010101010101000000000001010101010010000000000000000000000000000000001
1010101010101011111111101010101010010000000000000000000000000000000001
1010101010101010000000101010101010010000000000000000000000000000000001
1010101010101010111110101010101010010000000000000000000000000000000001
1010101010101010100010101010101010010000000000000000000000000000000001
1010101010101010101010101010101010010000000000000000000000000000000001
1010101010101010101010101010101010010000000000000000000000000000000001
1010101010101010101N10101010101010010000000000000000000000000000000001
1010101010101010100010101010101010010000000000000000000000000000000001
1010101010101010111110101010101010010000000000000000000000000000000001
1010101010101010000000101010101010010000000000000000000000000000000001
1010101010101011111111101010101010010000000000000000000000000000000001
1010101010101000000000001010101010010000000000000000000000000000000001
1010101010101111111111111010101010010000000000000000000000000000000001
1010101010100000000000000010101010010000000000000000000000000000000001
1010101010111111111111111110101010010000000000000000000000000000000001
1010101010000000000000000000101010010000000000000000000000000000000001
1010101011111111111111111111101010010000000000000000000000000000000001
1010101000000000000000000000001010010000000000000000000000000000000001
1010101111111111111111111111111010010000000000000000000000000000000001
1010100000000000000000000000000010010000000000000000000000000000000001
1010111111111111111111111111111110010000000000000000000000000000000001
1010000000000000000000000000000000010000000000000000000000000000000001
1011111111111111111111111111111111110000000000000000000000000000000001
1000000000000000000000000000000000000000000000000000000000000000000001
1000000000000000000000000000000000001111111111111111111111111111111111
1000000000000000000000000000000000001000000000000000000000000000000001
1000000000000000000000000000000000001011111111111111111111111111111101
1000000000000000000000000000000000001010000000000000000000000000000101
1000000000000000000000000000000000001010111111111111111111111111110101
1000000000000000000000000000000000001010100000000000000000000000010101
1000000000000000000000000000000000001010101111111111111111111111010101
1000000000000000000000000000000000001010101000000000000000000001010101
1000000000000000000000000000000000001010101011111111111111111101010101
1000000000000000000000000000000000001010101010000000000000000101010101
1000000000000000000000000000000000001010101010111111111111110101010101
1000000000000000000000000000000000001010101010100000000000010101010101
1000000000000000000000000000000000001010101010101111111111010101010101
1000000000000000000000000000000000001010101010101000000001010101010101
1000000000000000000000000000000000001010101010101011111101010101010101
1000000000000000000000000000000000001010101010101010000101010101010101
1000000000000000000000000000000000001010101010101010110101010101010101
1000000000000000000000000000000000001010101010101010010101010101010101
1000000000000000000000000000000000001010101010101010010101010101010101
1000000000000000000000000000000000001010101010101010110101010101010101
1000000000000000000000000000000000001010101010101010000101010101010101
1000000000000000000000000000000000001010101010101011111101010101010101
1000000000000000000000000000000000001010101010101000000001010101010101
1000000000000000000000000000000000001010101010101111111111010101010101
1000000000000000000000000000000000001010101010100000000000010101010101
1000000000000000000000000000000000001010101010111111111111110101010101
1000000000000000000000000000000000001010101010000000000000000101010101
1000000000000000000000000000000000001010101011111111111111111101010101
1000000000000000000000000000000000001010101000000000000000000001010101
1000000000000000000000000000000000001010101111111111111111111111010101
1000000000000000000000000000000000001010100000000000000000000000010101
1000000000000000000000000000000000001010111111111111111111111111110101
1000000000000000000000000000000000001010000000000000000000000000000101
1000000000000000000000000000000000001011111111111111111111111111111101
1000000000000000000000000000000000001000000000000000000000000000000001
1000000000000000000000000000000000001111111111111111111111111111111111
1111111111111111111111111111111111111111111111111111111111111111111111