NO ./textures/WallN.xpm
SO ./textures/WallS.xpm
WE ./textures/WallW.xpm
EA ./textures/WallE.xpm
F 220,1,0
C 225,30,0

1111111111111111111111111
1000000000110000000000001
1011000001110000000000001
1001000000000000000000001
1111111110110000000000001
1000000000110000011111111
1111011111111101110000001
1111011111111101110101001
1100000011010101110000001
1000000000000000110000001
1000000000000000110101001
1100000111010101110101111
111101111111010111N111101
1111111111111111111111111
